Name = Teh Roflz

Level = 66

Map = 2 0 0 0 0 0 0 0 0 1
0 2 0 0 0 0 0 0 1 0
0 0 2 0 0 0 0 1 0 0 
0 0 0 2 0 0 1 0 0 0 
0 0 0 0 2 1 0 0 0 0 
0 0 0 0 1 2 0 0 0 0 
0 0 0 1 0 0 2 0 0 0 
0 0 1 0 0 0 0 2 0 0 
0 1 0 0 0 0 0 0 2 0 
1 0 0 0 0 0 0 0 0 2 

some random stuff
more stuff

blah